operation;args1;args2;answer
and;0;0;0
and;0;1;0
and;1;0;0
and;1;1;1
or;0;0;0
or;0;1;1
or;1;0;1
or;1;1;1
xor;0;0;0
xor;0;1;1
xor;1;0;1
xor;1;1;0
imp;0;0;1
imp;0;1;1
imp;1;0;0
imp;1;1;1
eqv;0;0;1
eqv;0;1;0
eqv;1;0;0
eqv;1;1;1
